


NO textures/NO.xpm
SO textures/SO.xpm
WE textures/WE.xpm
EA textures/EA.xpm




F 117,118,113
C 44,93,197


11111111111111111111111111111111111
100000000010000000001100000000000011
100000000000110000011100000000000011
1000000000110010000000000000000000011
1000000000011000001110000000000001111
1000000000110000011101111100001111
111101111111110111000000100000001
111101111111110111010100100000001
110000001101010111000000100000001
100000000000000011000000100000001
100000000000000011010100100110001
1100000111010101111101111011E00111
11110111 1110101 1011110100000001
11111111 1111111 1111111111111111
